......|.....#.
.#..#||||...#.
.#..#~~#|.....
.#..#~~#|.....
.#~~~~~#|.....
.#~~~~~#|.....
.#######|.....
........|.....
...|||||||||..
...|#~~~~~#|..
...|#~~~~~#|..
...|#~~~~~#|..
...|#######|..
57
29
